########################
#  b        o          #
#               o      #
#    ##############    #
#    ##############    #
#     o    s           #
#               o      #
#    ##############    #
#    ##############    #
#              o     b #
#       s              #
#    ##############    #
#    ##############    #
#                      #
#                      #
#                      #
#########SSSSSS#########                      

