#########NNNNNN########                       
#                     #                       
#                b o  #                       
#         o   o       #                       
#      ###########    #                       
#      ###########    #                       
#      ###########    #                       
#             ooo     #                       
W                     E                                                                        
W           #      b  E                          
#           #         #                        
#           #         #                       
#    sss    #    o    #                        
#   #####   #   ###   #                       
#         b #         #                        
#           #         #                        
#######################                                                                


