########NNNNNN#########
#                     #   
#                     #    
#     #     o  #      #    
#  b  #        #      #    
#        o        b   #   
#     #        #      #             
#     #     o  #      #       
#                     #                       
#     # o      #      #
#     #    s   #      #   
# b    #      #       #     
#       #    #        #              
#       #    #        #   
#       #    #    b   #  
#       #  d #        #  
#######################
