########NNNNNN#########
#                     #   
#                     #    
#     #     o  #      #    
#  c  #        #      #    
#        o        c   #   
#     #        #      #             
#     #     o  #      #       
#                     #                       
#     # o      #      #
#     #    s   #      #   
# b    #      #       #     
#       #    #        #              
#       #    #        #   
#       #  d #    b   #  
#       #    #        #  
#######################
