########################                                                                           
#           #          #                                                                               
#           #          #            
#           #          #                 
#          ###         #                                                                               
#                      #      
#                      #                 
#                    ###                 
#                   ####                
#                      E                                       
#                      E                                     
#                   ####                                                         
#          ###       ###                                                                           
#           #          #                                     
#           #          #                     
#           #          #                                
########################                                                                                         
                
