########################                                                                           
#           #          #                                                                               
#           #          #            
#           #          #                 
#          ###         #                                                                               
#  p                   #      
#                      #                 
#                    ###                 
#                   ####                
#                      E                                       
#                      E                                     
#                 b ####                                                         
#          ###       ###                                                                           
#           #          #                                     
#           #          #                     
#           #          #                                
########################                                                                                         
                
