#######################                                                     
#    o  o  o  o  o    #                     
#    s  s  s  s  s    #                     
#    o  o  o  o  o    #         
#  ################   #       
#        ##sssss##    #                    
#       #####sss##    #                   
#          ##sss##    # 
#          ##sss##    #                   
W          ##ssss     E             
W          ##ssss     E                                         
#          ##sbs##    #     
#       #####sss##    #     
#           ######    #                  
#                     #                 
#                     #                            
#######################                                
                                                                                                  

