#######################                       
#                     #                       
#                     #                       
#            ###      #                       
#            ###      #                       
#                     #                       
#                     #                       
#                     #                       
#                     #                         
W                     #
W                     #
#      ###            #                       
#      ###            #                        
#                     #                       
#                     #                       
#                     #                       
#########SSSSSS########                                             

                   

