########################
#                      #
#                      #
#    ##############    #
#    ##############    #
#                      #
#                      #
#    ##############    #
#    ##############    #
#                      #
#                      #
#    ##############    #
#    ##############    #
#                      #
#                      #
#                      #
#########SSSSSS#########                      

