#######################                       
# #####   #############                       
# #####   #############                       
# #####              ##                       
#                    ##                       
#                     #                       
#                     #                       
#        ###          #                       
#        ###          E                         
#                     E
#                     #
#                     #                       
#                     #                        
#                ######                       
#                ######                       
#                ######                       
#######SSSSSS##########                                             

