########################                                                                                                        
#                      #                                                                               
#                      #               
################       #
#                      #
#                      #
#     ##########        
#     ##########        
#            ###        
#            ###        
###          ###       #                     
###################    #  
###################    #               
########               #                    
#                      #                    
#                      #                 
########      ##########                                                                                               
                      
