########################                                                                                                        
#                      #                                                                               
#                      #               
#                      #
#     ##########       #
#     #        ##      #
      #         ##     #
      #        ##      #
      #    #####       #
      #    ###         #
#     #                #                     
#     #          #     #  
#     ############     #               
#                      #                    
#                      #                    
#                      #                 
########################                                                                                               
                      
