########################                                                                                                        
#                      #                                                                               
#                      #               
#                      #
#     ##########       #
#     #        ##      #
W     #         ##     #
W     #        ##      #
W     #    #####       #
W     #    ###         #
#     #                #                     
#     #          #     #  
#     ############     #               
#                      #                    
#                      #                    
#                      #                 
########################                                                                                               
                      
