########################                                                                                                        
#             ####     #                                                                               
#             ####                     
#       ##              
#       ##              
#                       
#                      #
#######       ####     #
#######       ####     #
#                      #
#                      #                     
#       ####           #  
#       ####     ##    #               
#                ##    #                    
#                      #                    
#                      #                 
########      ##########                                                                                               
                      
