########################                                                                                                        
#                      #                                                                               
                       #               
                       #
                       #
                       #
#                      #
#                      #
#                      #
#                      #
#                      #                     
#                      #  
#                      #               
#                      #                    
#                      #                    
#                      #                 
########      ##########                                                                                               
                      
