########################                                                                                                        
#                      #                                                                               
                       #               
     ############      #
                       #
                       #
#####         ####     #
###############        #
#                      #
#                      #
####    ################                     
#                      #  
#                      #               
#################      #                    
#                      #                    
#                      #                 
########      ##########                                                                                               
                      
