#########      #########                                                                                                        
#                      #                                                                               
#                      #               
#                      #
#                      #
#                      #
#       #########      #
#      ###########      
#      ###########      
#      ###########      
#      ###########     #                     
#      ###########     #  
#      ###########     #               
#       #########      #                    
#                      #                    
#                      #                 
#########      #########                                                                                               
                      
