########################                                                                                                        
########################                                                                               
#    ##           ######               
#    ##                #
#    ##    ##          #
#    ##    ########    #
#    ##    ########    #
W    ##    ########    #
W          ##          #
W          ##          #
################   #####                     
#        #######   #####  
#                  #####               
#                  #####                    
#         ##############                    
#         ##############                 
#####SSSSS##############                                                                                               
                      
