########################                                                                                                        
########################                                                                               
#    ##           ######               
#    ##                #
#    ##    ##          #
#    ##    ########    #
#    ##    ########    #
     ##    ########    #
           ##          #
           ##          #
################   #####                     
#        #######   #####  
#                  #####               
#                  #####                    
#         ##############                    
#         ##############                 
#####     ##############                                                                                               
                      
