########################                                                                                                        
#                      #                                                                               
#                      #               
#                      #
#                      #
#                      #
#                      #
#                      #
#                      #
#                      #
#                      #                     
#                      #  
#                      #               
#                      #                    
#                      #                    
#                      #                 
########################                                                                                               
                      
