#########      #########                                                                                                        
#              #########                                                                               
#              #########               
#    ###################
#                      #
#                      #
#    #############     #
#                #     #
#                #     #
#      ###########     #
#      #               #                     
#      #               #  
#      #       ###     #               
#      #       #       #                    
#########      #       #                    
#########      #       #                 
#########      #########                                                                                               
                      
