#########      #########                                                                                                        
#                      #                                                                               
#                      #               
#                      #
#                      #
#                      #
#                      #
#                      #
#                      #
#                      #
#                      #                     
#                      #  
#                      #               
#                      #                    
#                      #                    
#                      #                 
#########      #########                                                                                               
                      
