#########NNNNNN#########                                                                                                        
#                      #                                                                               
#                      #               
#                      #
#                      #
#    ##############    #
#                      #
#                      #
#                      #
#########      #########
#                      #                     
#                      #  
#                      #               
#    ##############    #                    
#                      #                    
#                      #                 
#########SSSSSS#########                                                                                               
                      
