#########      #########                                                                                                        
#                      #                                                                               
#                      #               
#                      #
#                      #
#                      #
#                      #
#                      #
#                      #
#                      #
#                      #                     
#                      #  
#                      #               
#                      #                    
#                      #                    
#                      #                 
########################                                                                                               
                      
