#########NNNNNN#########                                                                                                        
#               ##     #                                                                               
#               ##     #               
#      ###########     #
#      ###########     #
#      ###########     #
#      ###########     #
#      ###########     #
#      ###########     #
#      ###########     #
#      ###########     #                     
#      ###########     #  
#      ###########     #               
#                      #                    
#                      #                    
#######        #########                 
########################                                                                                               
                      
