#########      #########                                                                                                        
#                      #                                                                               
#                      #               
#     ##################
#     ##################
#     ##################
#     ##################
#     ##################
#                       
#                       
#     ##################                     
#     ##################  
#     ##################               
#     ##################                    
#                      #                    
#                      #                 
########################                                                                                               
                      
