#########NNNNNN#########                                                                                                        
#                      #                                                                               
#                      #               
#     ##################
#     ##################
#     ##################
#     ##################
#     ##################
#                      E
#                      E
#     ##################                     
#     ##################  
#     ##################               
#     ##################                    
#                      #                    
#                      #                 
########################                                                                                               
                      
