#########      #########                                                                                                        
###                  ###                                                                               
###                  ###               
#        #####         #
#        #   #         #
#        #####         #
#                      # 
                        
         #####          
         #   #          
#        #####         #                     
#                      #  
#                      #               
#        #####         #                    
###      #   #       ###                    
###      #####       ###                 
########################                                                                                               
                      
