##########     #########                                                                                                        
#              #########                                                                               
#              #########               
#                      #
#                      #
#################      #
#          #    #      #
           #           #
           #           #
           #    #      #
#          #    #      #                     
#          #    #      #  
#               #      #               
#               #      #                    
#          #    #      #                    
#          #    #      #                 
########################                                                                                               
                      
