##########NNNNN#########                                                                                                        
#              #########                                                                               
#              #########               
#                      #
#                      #
#################      #
#          #    #      #
W          #           #
W          #           #
W          #    #      #
#          #    #      #                     
#          #    #      #  
#               #      #               
#               #      #                    
#          #    #      #                    
#          #    #      #                 
########################                                                                                               
                      
