########NNNNNN#########
#                     #   
#                     #    
#     #        #      #    
#     #        #      #    
#                     #   
#     #        #      #             
#     #        #      #       
#                     #                       
#     #        #      #
#     #        #      #   
#      #      #       #     
#       #    #        #              
#       #    #        #   
#       #    #        #  
#       #    #        #  
#######################
