########NNNNNN##########
#                      #   
#                      #    
#     #        #       #    
#     #        #       #    
#                      #   
#     #        #       #             
#     #        #       #       
#                      #                       
#     #        #       #
#     #        #       #   
#      #      #        #     
#       #    #         #              
#       #    #         #   
#       #    #         #  
#       #    #         #  
########################
