#########NNNNNN########
#   ###         ##    #                           
#    #          ##    #                                           
#    #          ##    #                                          
#    #          ##    #                           
#   ###         ##    #                                           
#   ###         ##    #                                      
#               ##    #                                          
#                     E                                        
#    #######          E                                            
#    #######          #                                      
#                     #                         
#                     #         
#   ########          #                     
#  ##########         #                  
#  ##########         #       
#######################
