#######################
#         ###         #                           
#                     #                                           
#                     #                                          
#         ###         #                           
#                     #                                           
#                     #                                      
#         ###         #                                          
W                     E                                       
W                     E                                     
#         ###         #                                      
#                     #                         
#                     #         
#         ###         #                     
#                     #                  
#                     #       
#######################
