#######################
#         #############
#                     #                  
#                     #                      
#                     #           
#                     #                      
#                     #                   
#                     #                      
W                     #            
W                     #           
#                     #
#    #######    ##    #
#    #######    ##    #
#               ##    #
#               ##    #
#         #############
#######################         
