#######################                                                     
#                     #                     
#  #   #              #                     
#  ##  #              #         
#  # # #              #       
#  #  ##              #                    
#  #   #              #                   
#                     # 
#                     #                   
W  #  #               E             
W  #  #               E                           
#  ####               #     
#  #  #               #     
#  #  #               #                  
#                     #                 
#                     #                            
#######################                                
