########     #########
#                    #
#          x          #  
#                    #
#      b     p       #
####      ### #      #
   #      #   ########
 s #      ###   s  o 
   #      #   ########
####      #          #
#         #          #
#                    #
#                    #
#          y          #
#                    #
########     #########
########     #########

