############################################
#                                          #
#                                          #  
#                                          #
#                                          #
#                                          #
#                                          #
#                                          #
#                                          #
#                                          #
#                                          #
#                                          #
#                                          # 
#                                          #
#                                          #
#                                          #
#                                          #
#                                          #
#                                          #
#                                          #
#                                          #
#                                          #
#                                          #
############################################

