########     #########
#                    #
#          x         #  
#                    #
#      p     b       #
####      ### #      #
   #      #   ########
 s #      ###   s  o 
   #      #   ########
####      #          #
#         #          #
#                  o #
#                    #
#          y         #
#                    #
########     #########
########     #########

