######################
#                    #
#        ##    ##    #  
#        ##    ##    #
#        ##    ##    #
#        ##    ##    #
#                    #
#                     
#   ############     
#   ############     #
#      #########     #
#      #########     #
#                    #
#                    #
#                    #
########             #
######################

