################################################################################################                                                                                  
#                      ##                      #                       #                       #       
#                      ##                      #                       #                       #
#                      ##                      #                       #                       #
#                      ##                      #                       #                       #       
#                      ##                      #                       #                       #
#                      ##                      #                       #                       #
#                      ##                      #                       #                       #
#                      ##                      #                       #                       #
#                      ##                      #                       #                       #
#                      ##                      #                       #                       #
#                      ##                      #                       #                       #
#                      ##                      #                       #                       #   
#                      ##                      #                       #                       #
#                      ##                      #                       #                       #
#                      ##                      #                       #                       #
################################################################################################                                                                                                
################################################################################################                                                                          
#                      ##                      ##                      ##                      #       
#                      ##                      ##                      ##                      #
#                      ##                      ##                      ##                      #
#                      ##                      ##                      ##                      #         
#                      ##                      ##                      ##                      #
#                      ##                      ##                      ##                      #
#                      ##                      ##                      ##                      #
#                      ##                      ##                      ##                      #
#                      ##                      ##                      ##                      #
#                      ##                      ##                      ##                      #
#                      ##                      ##                      ##                      #
#                      ##                      ##                      ##                      #    
#                      ##                      ##                      ##                      #
#                      ##                      ##                      ##                      #
#                      ##                      ##                      ##                      #
################################################################################################                             
################################################################################################                                                                           
#                      ##                      ##                      ##                      #                                   
#                      ##                      ##                      ##                      #
#                      ##                      ##                      ##                      #
#                      ##                      ##                      ##                      #                                   
#                      ##                      ##                      ##                      # 
#                      ##                      ##                      ##                      #
#                      ##                      ##                      ##                      #
#                      ##                      ##                      ##                      #
#                      ##                      ##                      ##                      #
#                      ##                      ##                      ##                      # 
#                      ##                      ##                      ##                      #              
#                      ##                      ##                      ##                      #                               
#                      ##                      ##                      ##                      #
#                      ##                      ##                      ##                      #
#                      ##                      ##                      ##                      #
################################################################################################                       
