#######################################################################
#                       #                        #                    #
#                       #                        #                    #
#                       #                        #                    #
#                       #                        #                    #
#                       #                        #                    #
#                       #                        #                    #
#                       #                        #                    #
#                       #                        #                    #
##########      ##################     ##################       #######                      
#                       #                        #                    #
#                       #                        #                    #
#                       #                        #                    #
#                                                                     #
#                                                                     #
#                       #                        #                    #
#                       #                        #                    #
#                       #                        #                    #
##########      ###############        #################         ######           
#                       #                        #                    #
#                       #                        #                    #
#                       #                        #                    #
#                       #                        #                    #
#                       #                        #                    #
#                       #                        #                    #
#                       #                        #                    #
#                       #                        #                    #
##########     #################       ################       #########
#                       #                        #                    #
#                       #                        #                    #
#                       #                        #                    #
#                       #                        #                    #
#                       #                        #                    #
#                       #                        #                    #
#                       #                        #                    #
#                       #                        #                    #
#######################################################################                       
