##############################################################################################################################################
#                       #                        #                    ##                       #                        #                    #
#                       #                        #                    ##                       #                        #                    #
#                       #                        #                    ##                       #                        #                    #
#                       #                        #                    ##                       #                        #                    #
#                       #                        #                    ##                       #                        #                    #
#                       #                        #                    ##                       #                        #                    #
#                       #                        #                    ##                       #                        #                    #
#                       #                        #                    ##                       #                        #                    #
##########      ##################     ##################       #################      ##################     ##################       #######                      
#                       #                        #                    ##                       #                        #                    #
#                       #                        #                    ##                       #                        #                    #
#                       #                        #                    ##                       #                        #                    #
#                                                                     ##                                                                     #
#                                                                     ##                                                                     #
#                       #                        #                    ##                       #                        #                    #
#                       #                        #                    ##                       #                        #                    #
#                       #                        #                    ##                       #                        #                    #
##########      ###############        #################         ################      ###############        #################         ######           
#                       #                        #                    ##                       #                        #                    #
#                       #                        #                    ##                       #                        #                    #
#                       #                        #                    ##                       #                        #                    #
#                       #                        #                    ##                       #                        #                    #
#                       #                        #                    ##                       #                        #                    #
#                       #                        #                    ##                       #                        #                    #
#                       #                        #                    ##                       #                        #                    #
#                       #                        #                    ##                       #                        #                    #
##########     #################       ################       ###################     #################       ################       #########
#                       #                        #                    ##                       #                        #                    #
#                       #                        #                    ##                       #                        #                    #
#                       #                        #                    ##                       #                        #                    #
#                       #                        #                    ##                       #                        #                    #
#                       #                        #                    ##                       #                        #                    #
#                       #                        #                    ##                       #                        #                    #
#                       #                        #                    ##                       #                        #                    #
#                       #                        #                    ##                       #                        #                    #
##############################################################################################################################################                       
