###########################################################################################
#                      #                     #                     #                      #
#                      #                     #                     #                      #
#                      #                     #                     #                      #
#                      #                     #                     #                      #
#                      #                     #                     #                      #
#                      #                     #                     #                      #
#                      #                     #                     #                      #
#                      #                     #                     #                      #
#                      #                     #                     #                      #
#                      #                     #                     #                      #
#                      #                     #                     #                      #
#                      #                     #                     #                      #
#                      #                     #                     #                      #
#                      #                     #                     #                      #
#                      #                     #                     #                      #
#########      ##################     ##################       #################      #####                      
###########################################################################################
#                      #                     #                     #                      #
#                      #                     #                     #                      #
#                      #                     #                     #                      #
#                      #                     #                     #                      #
#                      #                     #                     #                      #
#                      #                     #                     #                      #
#                      #                     #                     #                      #
#                      #                     #                     #                      #
#                      #                     #                     #                      #
#                      #                     #                     #                      #
#                      #                     #                     #                      #
#                      #                     #                     #                      #
#                      #                     #                     #                      #
#                      #                     #                     #                      #
#                      #                     #                     #                      #
#########      ##################     ##################       #################      #####                      
##########################################################################################3
#                      #                     #                     #                      #
#                      #                     #                     #                      #
#                      #                     #                     #                      #
#                      #                     #                     #                      #
#                      #                     #                     #                      #
#                      #                     #                     #                      #
#                      #                     #                     #                      #
#                      #                     #                     #                      #
#                      #                     #                     #                      #
#                      #                     #                     #                      #
#                      #                     #                     #                      #
#                      #                     #                     #                      #
#                      #                     #                     #                      #
#                      #                     #                     #                      #
#                      #                     #                     #                      #
#########      ##################     ##################       #################      #####                      
